%%%%%%%%%%%%%%%%%%%%%%%%%%%%%%%
%.o...%.................%...o.%
%.%%%.%.%%%.%%%%%%%.%%%.%.....%
%.%...%.%......%......%.%.....%
%...%%%.%.%%%%.%.%%%%...%%%...%
%%%.%.%.%.%......%..%.%...%.%%%
%...%.%%%.%.%%% %%%.%.%%%.%...%
%.%%%.......%GG GG%.......%%%.%
%...%.%%%%%.%%%%%%%.%.%%%.%...%
%%%.%...%.%....%....%.%...%.%%%
%...%%%.%.%%%%.%.%%%%.%.%%%...%
%.......%......%......%.....%.%
%.....%.%%%.%%%%%%%.%%%.%.%%%.%
%.o...%........P....%...%...o.%
%%%%%%%%%%%%%%%%%%%%%%%%%%%%%%%
